標準語 => 方言
朝早いうちに => あさげ
朝早いうちに大事な仕事を終わらせませんか => あさげのうちに大事な仕事おやさんかね
あらしまった => あっさーさ
あらしまった、もう少しばかり早ければ良かったのにね => あっさーさ、もうちょっと早ければいがったねや
遊び => あすび
あべこべ => あっちゃこっちゃ
あなたは シャツを前後ろあべこべに来ていますよ => おまんシャツあっちゃこっちゃにきてんでね
この、馬鹿野郎 => この、あったかさ
妹 => あばちゃ
姉さん => おねちゃ
あの時 => あんとき
具合 => あんべ
具合はどうですか？ => なじょだね？
具合悪いですよ => あんべ、わりでね
うるさい => うっせ
私は勉強しているんですから、あなた方うるさくしないでくれませんか => おら勉強してるんだすけ、おまんたうっせくしないでくんねかね
おいしい => うんめえ
俺のところのコシヒカリはとても美味しいのだ => おらとこのコシヒカリ、ばーかうんめえわ
よかった => えかった
悪い 病気じゃなくてよかったねぇ => わりい病気でなくえかったねや
弟 => おじ
兄 => あに
にいさん => あんちゃ
強く押しやる => おしこくる
その石 邪魔だからずっと押して行って => その石邪魔だすけおしっこくって
教える => おせえる
味噌汁 => おっちょ
一昨日 => おってな
一昨年 => おっとしな
一昨昨日 => さきおってな
お前たち、君たち => おまんた
あなた、君 => おまん
交換 => かえっこ
眩しい => かがっぽい
かしぐ。傾く => かしがる
木の切り株 => かぶつ
かき回す。かき混ぜる => かんもす
そのように鍋をかき回したら不味くなってしまいますよ => そんなに鍋かんもしちゃまずなっちゃうでね
汚い => きっちゃね
着物。洋服 => きもん
汚い着物を着ないで => きっちゃねきもん着るなや
昨日 => きんな
満タン。ふちっきり => くちっきり
ください。ちょうだい => くんない
くれないから。もらえないかな => くんねかね
それ私にくれないかな？ => それおらに君ねかね？
私の代わりに行ってもらえない => おらの代わりに行ってくんねかね
私 => おら
強く => げーに
強く叩く => げーにはたく
食べ残しのないように => げさんのないように
つまずく => けっつまずく
最下位 => げっぱ
煙 => けぶ
煙い => けぶって
ああ煙い煙い => ああけぶってけぶって
消す => けやす
日を消したかな => 火をけやしたかね
小汚い => こきちゃね
汚い => きっちゃね
くすぐる => こちょばす
くすぐったい => こちょばしい
ご馳走 => ごっつぉ
ごちそうさまです => ごっつぉさんです
この間 => こねだ
おやつ => こびり
今度 => こんだ
先ほど。さっき => さっきな
寒い => さびい
何度も。何回も => さんざ。さんざっぱら
若い頃、何度も何度もやったことは忘れていないね => 若い頃さんざしたことはわすんてねえねや
差し出す。手渡す => さんだす
折る => しっかく
お尻 => しっぺた
しおれる => しなびる
雨降らないから萎れてる => 雨降らんさけ、しなびてる
薄暗い => しゃぐれぇ
薄暗いな => しゃぐれぇな
おしゃべり => しゃべっちょ
あなた、おしゃべりだね => おまん、しゃべっちょだね
衆。人々 => しょ
隣の人たち => となりんしょ
恥ずかしい => しょうしい
私、恥ずかしかったです => おら、しょうしかったわね
不潔 => しょったれ
あなた、不潔だからね => おまん、しょったれだしね
ゆったり。ゆっくり。 => じょんのび
風呂入って、ゆったりしていってください => 風呂入って、じょんのびして行きないや
しんどい。苦しい => しんのい
〜だから => 〜すけ
そうだから、勘弁してください => そうだすけ、勘弁してくんない
言う => せう
あなた、言ったでしょ => おまん、せったねかね
そんなもの => そんつらもん
それで => そんで
それでも => そんでも
大変。難儀。 => たいそ
その仕事、大変ですね => その仕事、たいそだわ
だから => だすけ
そうだから、私は嫌です => そうだすけ、おらやだわね
大したことではない => たつけねぇ
おしゃれな人 => だてこき
熟しすぎる => たながおちる
おしっこが我慢できない => たれこち
縮む。小さくなる => ちぢこまる
冷たい => ちびて
ふざけて騒ぐ => ちゃわつく
つねる => つめくる
小皿 => てしょ
大事 => でーじ
大嫌い => でぇっきれ
でかい。大きい => でっかい
年寄り => としょり
どうだか => どうでら
どうでしょうね、私には分かりません => どうでらねや、おらにはわからん
どこかの人 => どっかんしょ
どこか => どっか
泣き虫 => なきみそ
具合はどうですか => なじょだね
どうして => なーして
無い => ねぇ
何もない => なんもねぇ
腐った匂いがする => ねぐせぇ
眠い => ねぶって
〜ねぇ => 〜ねや
そうだねぇ => そうだねや
一層。なおさら。 => のーか
とても => ばか
とても大きい => ばかでっけ
捗る => はかいく
〜ときたら。〜ばかりは => 〜ばっかしゃ
今度ばかりは => 今度ばっかしゃ
君ときたら、そんなことも分からないのか => おまんばっかしゃ、そんなこともわからんのかね
満腹 => はらくち
張り合いがない。寂しい。 => はりゃねぇ
それは、寂しいですね => そりゃ、はりゃねぇねかね
捨てる => ぶちゃる
昼休み => ひりゃすみ
背負う => ぶう
土 => べと
舌 => へら
では => ほしゃ
では、またね => ほしゃ、またね
放り投げる => ほんなげる
短い => みしかい
みっともない。器量が悪い。 => みったくない
見えない => めーない
申し訳ない => もうしゃけねぇ
明後日の次の日 => やね明後日
痛む => やめる
野郎ども => やんども
ゆっくり => やわやわ
湯 => よ
夜 => よーさ
余計なこと => よーでもねぇ
昨夜 => よんべな
悪さ。いたずら => わんさ
骨折してしまった (標準語訳) => 骨しょっちゃった(方言)
あら、あなたどうしたの。ギブスなんか巻いて。 => あら、おまん、なーしたな。 ギブスなんか巻いて
それがね、あなた、まあ聞いてくれない。 => それがさ、おまん、まあ聞いてくんねかね。
もうじき春だから、種芋の支度でもしておこうと思ってね、昨日雪に埋まりながら、物置き小屋へ行ったのよ。 => もうじき春だすけさ、種芋の支度でもしとこと思ってさね、きんな雪どかして物置小屋へ行ったんだわね。
物置の中、薄暗くてね、足元がよく見えなかったのね、散らしてあった縄に絡まって、強く転んでしまったのよ。 => 物置ん中、しゃぐらくてさ、足元よくめえねかったんだねや、散らばしてあった縄にけっからんで、すっころんだんだわね。
その所にあった、大きな石に、膝をぶつけてね、歩けなくなってしまったの。 => そこんとこにあった、でっけぇ石に、膝ぶっつけてさ、歩がんねくなったんだわ。
いくら爺さんを呼んでも、全く耳が聞こえないので、駄目でね、這ってやっと家まで来たけど、冷たいわ、とても痛いわで、閉口したわよ。 => いっくらじさ呼ばっても、かなつんぼだすけ、聞けえねしさ、へえずってやっとこさ家まで来たんだでも、冷てえわ、ばっがいてえわ、えれぇごとだったわね。
すぐお医者さまのところへ、連れて行ってもらったのだけど、レントゲン撮ったら、膝蓋骨々折があってね。 => すぐに医者んとこ、つんてってもらったんだでも、レントゲンとったら、皿割んててさ。
お医者さまは、『じっと寝て、つららでも付けておけ!』なんておっしゃるのよ。 => 『じっと寝て、かねっこりでもおっつけておけ!』なんて言うんだわね。
『私は忙しくて、寝てなどいられない』って言ったら、このような物巻かれたの。 => 『おらせわしくて、寝てなんかいらんね!』って せったら、こんなもん巻かれたんだわね。
だから、歩けるけど、急げないわね => ださげ、あるげるけど、急がんねしねや。
それは、大変だったね。 => そりゃ、てえへんだったねや。
何か手伝いすることがあれば、言ってよ。 => なんかてんでいすることありぁ、せってくんないや。
ありがとうね。爺さんと二人だけだから、その辺にあるもの食べているわ。雪消えるまでは暇ですしね。 => ありがとね。じさと二人だけだすけ、そごらにあるもん食ってんわね。雪けえるまでは暇だしねや。
若いころは、藁仕事や繕い物など、一冬中仕事があったけど、今は何もしないしねえ。寄ってお茶でも飲んで行かない? => わけぇころは、わら仕事やつくろいもんなんか、冬中仕事あったでも、今はなんもしねえしねや。寄って茶でも飲んでいかんかね
そうねえ。だけどうちの爺さんは、焼きもちやきでねぇ。行く先を言わないで、いなくなると、まあぶつぶつ言うのよ。 => そうだねや。だどもおらじさ、焼きもちやくんだわね。行く先言わんで、いなくなんと、まあおごってさね。
今日は帰るわ。 今度、爺さんに言ってお邪魔するわ。 => 今日はけえるわ。 こんだ、じさにせってくんすけ。
あれまあ、おたくの爺さん、焼きもちやくというの。婆ちゃん大した美人でもないのにねぇ。 => あらま、おまんたじさ、 焼きもちやくってかね。 ばあちゃ、てえしてきりょういぐねえなに。
何言うのよ。うちの爺さん、私を村中で一番の美人だって言ったから、私嫁に来たのよ。 => 何言ってんね。おらじさ、おらぼ村中で一番のきりょうよしだせったすけ、おら嫁にきたんだでね。
お宅のお爺さん、このごろ、眼が悪くなったって言っていたけど、若いころから悪かったんだね。 => おまんたじさ、このごろ、眼え悪くなったってせってたでも、若ぇころから悪かったんかね。
馬鹿言わないでよ、爺さんはよい眼をしていたので、私の美しさが分かったんだよ。 => ばかいいなんな、じさええ眼してたすけ、おらのきりょうよしわかったんだねかね。
まあいいじゃないの、私と爺さんのことだから。 => まあええわね、おらとじさのこったさげ。
では、大事にしなさいよ => ほしゃ、でーじにしねや。